fg2a,fg_pct,fg2,fg3,team_name,pts,tov,fta,pf,blk,ft_pct,fg3a,ft,ast,season,fg3_pct,fg,orb,fga,g,stl,trb,fg2_pct,mp,drb
4992,.477,2555,796,Phoenix Suns*,9054,1125,2080,1563,453,.748,2026,1556,1927,04/05,.393,3351,967,7018,82,572,3619,.512,19780,2652
5582,.459,2681,522,Sacramento Kings*,8505,1073,2004,1685,316,.787,1396,1577,2005,04/05,.374,3203,1023,6978,82,674,3478,.480,19855,2455
5418,.457,2595,463,Dallas Mavericks*,8405,1102,2314,1827,461,.789,1273,1826,1610,04/05,.364,3058,990,6691,82,708,3520,.479,19730,2530
5108,.486,2622,475,Miami Heat*,8327,1127,2466,1814,474,.672,1260,1658,1790,04/05,.377,3097,887,6368,82,528,3526,.513,19980,2639
5259,.468,2609,437,Boston Celtics*,8304,1297,2323,2000,423,.764,1252,1775,1810,04/05,.349,3046,909,6511,82,667,3347,.496,19880,2438
5296,.437,2452,514,Washington Wizards*,8241,1172,2476,1807,347,.725,1498,1795,1563,04/05,.343,2966,1133,6794,82,716,3507,.463,19780,2374
4975,.444,2304,648,Toronto Raptors,8178,1087,2101,1876,317,.774,1681,1626,1670,04/05,.385,2952,844,6656,82,621,3288,.463,19805,2444
5675,.459,2718,320,Denver Nuggets*,8161,1224,2313,1878,489,.763,940,1765,1958,04/05,.340,3038,967,6615,82,750,3440,.479,19755,2473
5763,.454,2714,320,Orlando Magic,8160,1322,2335,1937,441,.759,916,1772,1583,04/05,.349,3034,1038,6679,82,633,3582,.471,19705,2544
5283,.437,2441,505,Philadelphia 76ers*,8128,1274,2194,1878,321,.789,1453,1731,1710,04/05,.348,2946,909,6736,82,756,3445,.462,19855,2536
4674,.444,2216,666,Seattle SuperSonics*,8113,1113,2131,1944,338,.790,1824,1683,1487,04/05,.365,2882,1041,6498,82,553,3352,.474,19755,2311
4816,.437,2251,644,Los Angeles Lakers,8095,1176,2137,1794,344,.777,1813,1661,1672,04/05,.355,2895,1028,6629,82,508,3539,.467,19780,2511
5265,.430,2405,624,Golden State Warriors,8094,1112,1955,1833,420,.722,1774,1412,1811,04/05,.352,3029,1069,7039,82,642,3505,.457,19905,2436
5359,.451,2537,441,New York Knicks,7977,1204,2060,1942,260,.767,1240,1580,1665,04/05,.356,2978,965,6599,82,629,3358,.473,19880,2393
5655,.450,2639,325,Milwaukee Bucks,7973,1132,2229,1797,289,.772,925,1720,1720,04/05,.351,2964,985,6580,82,529,3390,.467,19780,2405
5484,.459,2650,395,Minnesota Timberwolves,7934,1079,1820,1774,447,.796,1145,1449,1918,04/05,.345,3045,947,6629,82,460,3527,.483,19755,2580
5783,.447,2690,300,Cleveland Cavaliers,7914,1141,2174,1850,461,.752,904,1634,1851,04/05,.332,2990,1117,6687,82,654,3469,.465,19855,2352
5055,.453,2416,507,San Antonio Spurs*,7888,1126,2120,1717,543,.724,1395,1535,1771,04/05,.363,2923,987,6450,82,613,3476,.478,19805,2489
5699,.459,2693,231,Los Angeles Clippers,7849,1290,2274,1819,422,.778,669,1770,1901,04/05,.345,2924,980,6368,82,599,3435,.473,20030,2455
4898,.443,2293,553,Houston Rockets*,7796,1135,1986,1807,378,.781,1521,1551,1733,04/05,.364,2846,874,6419,82,563,3475,.468,19855,2601
5159,.432,2338,511,Chicago Bulls*,7745,1371,2048,2028,369,.750,1433,1536,1743,04/05,.357,2849,1001,6592,82,576,3592,.453,19830,2591
5978,.432,2641,320,Charlotte Bobcats,7729,1192,2096,1894,440,.709,881,1487,1794,04/05,.363,2961,1083,6859,82,695,3418,.442,19880,2335
4785,.447,2271,531,Memphis Grizzlies*,7661,1197,2024,1910,476,.754,1486,1526,1716,04/05,.357,2802,887,6271,82,699,3194,.475,19705,2307
5368,.444,2488,363,Detroit Pistons*,7653,1133,2150,1638,497,.739,1053,1588,1787,04/05,.345,2851,1054,6421,82,576,3561,.463,19955,2507
4594,.432,2126,542,Indiana Pacers*,7626,1173,2206,1890,357,.792,1575,1748,1489,04/05,.344,2668,868,6169,82,615,3286,.463,19905,2418
5539,.449,2578,250,Utah Jazz,7625,1292,2272,2189,374,.757,762,1719,1826,04/05,.328,2828,1047,6301,82,541,3290,.465,19780,2243
5261,.451,2476,420,Portland Trail Blazers,7621,1308,1944,1703,544,.725,1161,1409,1722,04/05,.362,2896,970,6422,82,583,3374,.471,19730,2404
5699,.441,2638,304,Atlanta Hawks,7605,1319,1994,2009,344,.711,973,1417,1614,04/05,.312,2942,1100,6672,82,629,3435,.463,19855,2335
5216,.429,2318,435,New Jersey Nets*,7496,1164,2039,1985,308,.763,1203,1555,1772,04/05,.362,2753,855,6419,82,650,3242,.444,19905,2387
5240,.415,2303,415,New Orleans Hornets,7252,1217,1830,1883,310,.766,1316,1401,1724,04/05,.315,2718,1019,6556,82,550,3300,.440,19930,2281
5070,.479,2593,837,Phoenix Suns*,8886,1088,1475,1683,412,.806,2097,1189,2179,05/06,.399,3430,778,7167,82,549,3428,.511,19955,2650
5080,.459,2472,605,Seattle SuperSonics,8411,1208,2104,1933,306,.785,1631,1652,1696,05/06,.371,3077,1013,6711,82,622,3246,.487,19830,2233
5262,.447,2478,497,Washington Wizards*,8336,1143,2496,1855,339,.757,1394,1889,1523,05/06,.357,2975,1035,6656,82,658,3379,.471,19830,2344
5019,.454,2405,608,Toronto Raptors,8287,1071,2089,1965,272,.791,1620,1653,1593,05/06,.375,3013,864,6639,82,529,3155,.479,19955,2291
5596,.461,2728,350,Denver Nuggets*,8227,1216,2312,1863,463,.744,1076,1721,1921,05/06,.325,3078,903,6672,82,698,3389,.487,19930,2486
4914,.478,2542,497,Miami Heat*,8191,1186,2310,1871,442,.700,1441,1616,1692,05/06,.345,3039,858,6355,82,522,3533,.517,19755,2675
5024,.453,2440,552,Los Angeles Lakers*,8154,1143,2172,1894,350,.745,1583,1618,1734,05/06,.349,2992,970,6607,82,628,3458,.486,19855,2488
5515,.458,2626,375,Philadelphia 76ers,8147,1159,2330,1712,404,.760,1031,1770,1653,05/06,.364,3001,873,6546,82,651,3298,.476,19905,2425
5262,.462,2532,416,Dallas Mavericks*,8130,1112,2322,1834,488,.783,1113,1818,1473,05/06,.374,2948,1030,6375,82,593,3461,.481,19880,2431
5092,.454,2460,494,Sacramento Kings*,8106,1199,2173,1672,299,.784,1408,1704,1825,05/06,.351,2954,852,6500,82,608,3325,.483,19830,2473
4953,.433,2314,625,Golden State Warriors,8076,1156,2190,1941,357,.718,1832,1573,1694,05/06,.341,2939,980,6785,82,604,3465,.467,19830,2485
5032,.467,2484,467,Boston Celtics,8033,1359,2204,2033,422,.755,1290,1664,1716,05/06,.362,2951,813,6322,82,578,3245,.494,19880,2432
5231,.453,2469,507,Milwaukee Bucks*,8020,1197,2115,1902,270,.738,1335,1561,1769,05/06,.380,2976,929,6566,82,597,3377,.472,19855,2448
5260,.446,2444,560,Chicago Bulls*,8020,1224,1967,2038,345,.738,1477,1452,1804,05/06,.379,3004,906,6737,82,508,3508,.465,19905,2602
4947,.454,2411,497,Cleveland Cavaliers*,8002,1137,2318,1733,392,.729,1465,1689,1560,05/06,.339,2908,959,6412,82,567,3470,.487,19830,2511
5342,.454,2522,424,Atlanta Hawks,7972,1284,2207,2054,394,.750,1154,1656,1625,05/06,.367,2946,1069,6496,82,587,3301,.472,19880,2232
5600,.465,2703,290,Los Angeles Clippers*,7970,1185,2142,1872,503,.791,843,1694,1708,05/06,.344,2993,828,6443,82,534,3532,.483,19805,2704
5582,.433,2533,428,Charlotte Bobcats,7943,1167,2186,1960,354,.729,1261,1593,1717,05/06,.339,2961,990,6843,82,822,3260,.454,19905,2270
5107,.455,2426,557,Detroit Pistons*,7941,931,1950,1513,490,.727,1451,1418,1971,05/06,.384,2983,975,6558,82,580,3322,.475,19830,2347
5322,.455,2502,320,New York Knicks,7842,1449,2587,2157,271,.726,884,1878,1468,05/06,.362,2822,1034,6206,82,555,3394,.470,19930,2360
4980,.472,2469,524,San Antonio Spurs*,7837,1126,1891,1714,467,.702,1362,1327,1717,05/06,.385,2993,851,6342,82,543,3399,.496,19805,2548
5371,.472,2612,299,Orlando Magic,7784,1240,2277,1908,362,.730,796,1663,1495,05/06,.376,2911,892,6167,82,532,3294,.486,19905,2402
4738,.444,2250,536,Indiana Pacers*,7699,1254,2158,1821,409,.737,1536,1591,1631,05/06,.349,2786,898,6274,82,598,3457,.475,19730,2559
4870,.440,2301,477,New Jersey Nets*,7691,1119,2187,1903,278,.758,1447,1658,1884,05/06,.330,2778,822,6317,82,558,3361,.472,19780,2539
5543,.440,2531,300,New Orleans/Oklahoma City Hornets,7611,1095,2176,1786,311,.758,885,1649,1519,05/06,.339,2831,918,6428,82,611,3297,.457,19805,2379
5282,.442,2433,311,Utah Jazz,7573,1290,2466,2032,492,.719,925,1774,1772,05/06,.336,2744,1071,6207,82,524,3451,.461,19880,2380
4547,.448,2156,590,Memphis Grizzlies*,7558,1134,2077,1757,442,.711,1578,1476,1586,05/06,.374,2746,834,6125,82,600,3213,.474,19855,2379
5398,.456,2578,310,Minnesota Timberwolves,7522,1189,1895,1889,471,.758,942,1436,1716,05/06,.329,2888,811,6340,82,559,3233,.478,19855,2422
4838,.433,2239,469,Houston Rockets,7387,1193,1980,1863,320,.759,1414,1502,1580,05/06,.332,2708,849,6252,82,588,3414,.463,19830,2565
5225,.445,2427,364,Portland Trail Blazers,7285,1205,1944,1828,435,.689,1042,1339,1490,05/06,.349,2791,886,6267,82,529,3089,.464,19730,2203
4890,.494,2603,785,Phoenix Suns*,9037,1189,1827,1659,394,.808,1965,1476,2122,06/07,.399,3388,737,6855,82,553,3320,.532,19905,2583
5081,.463,2561,700,Golden State Warriors*,8737,1309,2113,1933,466,.717,1967,1515,1950,06/07,.356,3261,940,7048,82,750,3396,.504,19755,2456
5365,.465,2680,484,Denver Nuggets*,8639,1352,2449,1756,435,.746,1440,1827,1920,06/07,.336,3164,1001,6805,82,678,3559,.500,19780,2558
5206,.450,2509,561,Washington Wizards*,8556,1133,2425,1823,375,.765,1614,1855,1660,06/07,.348,3070,998,6820,82,635,3377,.482,19830,2379
4940,.466,2495,608,Los Angeles Lakers*,8474,1273,2221,1889,421,.747,1724,1660,1850,06/07,.353,3103,886,6664,82,600,3381,.505,20030,2495
5086,.465,2498,500,Memphis Grizzlies,8331,1343,2410,1827,407,.761,1362,1835,1680,06/07,.367,2998,866,6448,82,564,3241,.491,19980,2375
5415,.474,2715,354,Utah Jazz*,8322,1277,2462,2067,339,.743,1056,1830,2024,06/07,.335,3069,1030,6471,82,577,3486,.501,19805,2456
5019,.450,2411,530,Sacramento Kings,8303,1194,2473,1792,265,.765,1513,1891,1665,06/07,.350,2941,797,6532,82,671,3193,.480,19805,2396
5038,.467,2475,535,Dallas Mavericks*,8201,1140,2045,1837,408,.805,1404,1646,1632,06/07,.381,3010,920,6442,82,560,3435,.491,19755,2515
5242,.465,2597,524,Milwaukee Bucks,8172,1240,1919,1821,224,.733,1472,1406,1771,06/07,.356,3121,941,6714,82,587,3213,.495,19855,2272
5083,.463,2501,531,Toronto Raptors*,8157,1104,1982,1672,321,.788,1464,1562,1822,06/07,.363,3032,755,6547,82,581,3235,.492,19755,2480
5177,.460,2522,525,Seattle SuperSonics,8130,1268,1911,1801,301,.791,1451,1511,1695,06/07,.362,3047,928,6628,82,631,3250,.487,19830,2322
5426,.457,2566,480,Chicago Bulls*,8100,1310,2083,1908,445,.734,1237,1528,1832,06/07,.388,3046,984,6663,82,639,3581,.473,19780,2597
4767,.474,2404,595,San Antonio Spurs*,8079,1137,1980,1588,417,.751,1561,1486,1814,06/07,.381,2999,761,6328,82,587,3338,.504,19780,2577
4703,.457,2304,609,New Jersey Nets*,8001,1212,2153,1869,273,.727,1676,1566,1962,06/07,.363,2913,822,6379,82,499,3347,.490,19880,2525
4986,.457,2429,474,New York Knicks,7994,1405,2396,1932,260,.715,1370,1714,1532,06/07,.346,2903,1032,6356,82,543,3548,.487,20005,2516
4635,.445,2201,705,Houston Rockets*,7953,1162,1906,1710,337,.753,1893,1436,1704,06/07,.372,2906,880,6528,82,583,3553,.475,19855,2673
5363,.446,2503,457,Charlotte Bobcats,7945,1224,2136,1985,369,.734,1280,1568,1836,06/07,.357,2960,920,6643,82,638,3266,.467,20005,2346
5254,.447,2484,494,Cleveland Cavaliers*,7934,1177,2133,1781,353,.696,1404,1484,1708,06/07,.352,2978,1039,6658,82,625,3568,.473,19880,2529
5414,.461,2613,384,Minnesota Timberwolves,7877,1278,1892,1758,325,.792,1089,1499,1848,06/07,.353,2997,819,6503,82,532,3293,.483,20005,2474
5179,.454,2493,449,Detroit Pistons*,7872,1001,1988,1672,472,.774,1305,1539,1768,06/07,.344,2942,948,6484,82,583,3322,.481,19880,2374
5171,.443,2387,471,Boston Celtics,7857,1350,2178,1971,382,.767,1283,1670,1630,06/07,.367,2858,918,6454,82,589,3309,.462,19855,2391
5415,.456,2566,314,Los Angeles Clippers,7843,1239,2245,1858,472,.788,903,1769,1762,06/07,.348,2880,888,6318,82,596,3372,.474,19730,2484
5172,.438,2391,481,Indiana Pacers,7840,1335,2125,1912,447,.760,1389,1615,1680,06/07,.346,2872,990,6561,82,599,3431,.462,19780,2441
5418,.445,2516,455,New Orleans/Oklahoma City Hornets,7833,1187,1941,1620,347,.740,1256,1436,1537,06/07,.362,2971,1025,6674,82,522,3537,.464,19880,2512
5585,.458,2648,284,Philadelphia 76ers,7785,1258,2135,1671,390,.767,823,1637,1669,06/07,.345,2932,899,6408,82,590,3252,.474,19880,2353
5128,.472,2533,342,Orlando Magic*,7771,1392,2393,1904,416,.702,962,1679,1525,06/07,.356,2875,920,6090,82,565,3338,.494,19780,2418
4749,.464,2391,528,Miami Heat*,7759,1201,2019,1749,442,.690,1539,1393,1681,06/07,.343,2919,817,6288,82,566,3343,.503,19855,2526
5160,.450,2448,426,Portland Trail Blazers,7717,1236,2006,1931,380,.769,1232,1543,1513,06/07,.346,2874,923,6392,82,555,3222,.474,19955,2299
5334,.444,2490,341,Atlanta Hawks,7680,1306,2203,1970,446,.761,1038,1677,1573,06/07,.329,2831,976,6372,82,609,3288,.467,19880,2312
5221,.459,2642,761,Golden State Warriors,9105,1082,2044,1875,377,.752,2185,1538,1833,07/08,.348,3403,1045,7406,82,744,3541,.506,19780,2496
5433,.470,2738,569,Denver Nuggets*,9074,1203,2519,1731,551,.751,1605,1891,2024,07/08,.355,3307,918,7038,82,752,3616,.504,19855,2698
5018,.500,2698,694,Phoenix Suns*,9026,1184,1977,1633,518,.783,1764,1548,2188,07/08,.393,3392,720,6782,82,532,3403,.538,19780,2683
5067,.476,2586,662,Los Angeles Lakers*,8904,1156,2270,1691,438,.769,1751,1746,2003,07/08,.378,3248,898,6818,82,654,3620,.510,19780,2722
5497,.497,2872,407,Utah Jazz*,8710,1200,2298,1970,355,.759,1095,1745,2165,07/08,.372,3279,942,6592,82,717,3352,.522,19705,2410
4372,.474,2257,801,Orlando Magic*,8567,1173,2288,1688,333,.721,2074,1650,1706,07/08,.386,3058,768,6446,82,520,3445,.516,19780,2677
4972,.444,2347,755,Indiana Pacers,8527,1236,2042,1921,412,.768,2021,1568,1864,07/08,.374,3102,904,6993,82,623,3537,.472,19755,2633
5191,.464,2533,510,Sacramento Kings,8408,1317,2272,1839,334,.798,1367,1812,1567,07/08,.373,3043,829,6558,82,651,3285,.488,19830,2456
5175,.466,2534,630,New Orleans Hornets*,8270,974,1707,1531,321,.769,1621,1312,1785,07/08,.389,3164,937,6796,82,637,3431,.490,19805,2494
4958,.454,2440,620,Memphis Grizzlies,8257,1251,2097,1592,386,.723,1779,1517,1574,07/08,.349,3060,848,6737,82,503,3415,.492,19805,2567
4722,.475,2390,596,Boston Celtics*,8245,1246,2176,1864,379,.771,1564,1677,1833,07/08,.381,2986,830,6286,82,696,3445,.506,19755,2615
5112,.464,2531,494,Dallas Mavericks*,8234,1037,2075,1786,402,.814,1403,1690,1720,07/08,.352,3025,883,6515,82,490,3526,.495,19730,2643
5267,.468,2576,572,Toronto Raptors*,8215,959,1658,1596,336,.812,1459,1347,1953,07/08,.392,3148,790,6726,82,570,3286,.489,19830,2496
5081,.446,2411,575,Washington Wizards*,8104,1082,1991,1606,391,.782,1614,1557,1607,07/08,.356,2986,1007,6695,82,632,3411,.475,19905,2404
5474,.454,2591,384,Atlanta Hawks*,8054,1223,2227,1673,448,.772,1078,1720,1804,07/08,.356,2975,1008,6552,82,600,3462,.473,19855,2454
6093,.444,2812,313,Seattle SuperSonics,7999,1310,1866,1680,400,.770,939,1436,1748,07/08,.333,3125,971,7032,82,531,3659,.462,19830,2688
5221,.458,2512,487,Detroit Pistons*,7992,956,1965,1688,472,.767,1330,1507,1831,07/08,.366,2999,974,6551,82,583,3397,.481,19730,2423
5556,.435,2513,474,Chicago Bulls,7981,1197,2029,1784,429,.756,1305,1533,1811,07/08,.363,2987,1050,6861,82,635,3528,.452,19805,2478
5111,.452,2431,529,Charlotte Bobcats,7959,1204,2115,1777,402,.714,1443,1510,1748,07/08,.367,2960,892,6554,82,614,3332,.476,19880,2440
5432,.449,2574,452,Milwaukee Bucks,7956,1210,1980,1748,361,.733,1313,1452,1760,07/08,.344,3026,1055,6745,82,544,3418,.474,19855,2363
5303,.439,2477,490,New York Knicks,7948,1187,2095,1761,213,.727,1454,1524,1530,07/08,.337,2967,1029,6757,82,521,3486,.467,19880,2457
4991,.448,2420,583,Houston Rockets*,7931,1125,1848,1609,420,.726,1707,1342,1757,07/08,.342,3003,1002,6698,82,598,3661,.485,19730,2659
5696,.460,2754,302,Philadelphia 76ers*,7923,1172,2137,1620,400,.706,952,1509,1673,07/08,.317,3056,1067,6648,82,712,3437,.483,19755,2370
5153,.439,2385,552,Cleveland Cavaliers*,7903,1145,2061,1712,427,.717,1544,1477,1640,07/08,.358,2937,1092,6697,82,579,3655,.463,19855,2563
5020,.443,2358,498,New Jersey Nets,7857,1229,2237,1855,390,.736,1430,1647,1925,07/08,.348,2856,913,6450,82,521,3433,.470,19830,2520
5558,.451,2635,441,Minnesota Timberwolves,7839,1188,1693,1885,306,.736,1259,1246,1630,07/08,.350,3076,964,6817,82,616,3392,.474,19730,2428
4814,.457,2344,594,San Antonio Spurs*,7820,1035,1774,1537,337,.761,1610,1350,1718,07/08,.369,2938,771,6424,82,521,3383,.487,19730,2612
5120,.448,2397,538,Portland Trail Blazers,7820,1056,1841,1642,360,.767,1426,1412,1733,07/08,.377,2935,901,6546,82,455,3339,.468,19905,2438
5366,.438,2470,350,Los Angeles Clippers,7692,1180,2178,1745,398,.781,1079,1702,1732,07/08,.324,2820,800,6445,82,557,3291,.460,19805,2491
4963,.443,2317,491,Miami Heat,7491,1202,1903,1670,355,.727,1373,1384,1644,07/08,.358,2808,743,6336,82,589,3085,.467,19830,2342
5250,.504,2820,553,Phoenix Suns,8974,1288,2251,1691,420,.744,1445,1675,1905,08/09,.383,3373,900,6695,82,589,3420,.537,19755,2520
5580,.458,2681,550,Golden State Warriors,8905,1201,2392,1842,527,.791,1475,1893,1711,08/09,.373,3231,953,7055,82,638,3445,.480,19880,2492
5465,.474,2760,547,Los Angeles Lakers*,8768,1103,2087,1698,420,.770,1516,1607,1908,08/09,.361,3307,1015,6981,82,718,3602,.505,19780,2587
4807,.445,2334,823,New York Knicks,8627,1174,1900,1672,204,.784,2284,1490,1738,08/09,.360,3157,911,7091,82,610,3456,.486,19805,2545
5355,.455,2568,652,Indiana Pacers,8617,1189,1890,1895,434,.807,1725,1525,1775,08/09,.378,3220,924,7080,82,573,3585,.480,19830,2661
5033,.470,2510,548,Denver Nuggets*,8555,1257,2487,1874,492,.760,1477,1891,1820,08/09,.371,3058,905,6510,82,710,3412,.499,19730,2507
5501,.475,2751,392,Utah Jazz*,8492,1210,2352,1830,374,.771,1122,1814,2024,08/09,.349,3143,940,6623,82,719,3363,.500,19880,2423
5553,.457,2633,493,Chicago Bulls*,8378,1192,2052,1709,453,.796,1293,1633,1732,08/09,.381,3126,970,6846,82,615,3451,.474,19930,2481
5138,.462,2557,571,Dallas Mavericks*,8343,1043,1852,1600,429,.819,1632,1516,1779,08/09,.350,3128,909,6770,82,591,3504,.498,19805,2595
4269,.457,2112,817,Orlando Magic*,8286,1142,2253,1664,439,.715,2147,1611,1593,08/09,.381,2929,819,6416,82,570,3547,.495,19730,2728
4978,.486,2537,538,Boston Celtics*,8275,1280,2075,1897,387,.765,1355,1587,1862,08/09,.397,3075,869,6333,82,621,3455,.510,19880,2586
5091,.447,2404,586,Sacramento Kings,8248,1266,2107,1910,349,.798,1594,1682,1619,08/09,.368,2990,840,6685,82,569,3206,.472,19905,2366
4784,.468,2366,656,Cleveland Cavaliers*,8223,1045,2012,1663,435,.757,1670,1523,1663,08/09,.393,3022,886,6454,82,593,3460,.495,19780,2574
4939,.465,2422,596,Portland Trail Blazers*,8153,1055,1988,1671,402,.765,1555,1521,1667,08/09,.383,3018,1060,6494,82,550,3420,.490,19830,2360
5347,.445,2498,511,Milwaukee Bucks,8142,1154,2067,1986,308,.780,1408,1613,1802,08/09,.363,3009,973,6755,82,609,3340,.467,19780,2367
5384,.458,2575,479,Toronto Raptors,8121,1098,1861,1593,390,.824,1289,1534,1835,08/09,.372,3054,802,6673,82,523,3315,.478,19805,2513
4870,.453,2338,621,Houston Rockets*,8070,1158,1903,1553,355,.805,1656,1531,1662,08/09,.375,2959,862,6526,82,548,3524,.480,19805,2662
5015,.457,2452,582,Miami Heat*,8061,1026,1871,1696,451,.754,1631,1411,1671,08/09,.357,3034,828,6646,82,651,3239,.489,19955,2411
4818,.458,2359,597,Atlanta Hawks*,8046,1048,2085,1610,376,.737,1633,1537,1657,08/09,.366,2956,870,6451,82,603,3282,.490,19705,2412
4801,.448,2273,652,New Jersey Nets,8044,1075,1980,1838,391,.779,1735,1542,1636,08/09,.376,2925,850,6536,82,559,3265,.473,19830,2415
5227,.441,2443,543,Minnesota Timberwolves,8019,1165,1957,1785,322,.769,1539,1504,1674,08/09,.353,2986,975,6766,82,512,3417,.467,19805,2442
5460,.459,2656,341,Philadelphia 76ers*,7987,1157,2216,1650,415,.745,1072,1652,1647,08/09,.318,2997,1039,6532,82,658,3375,.486,19755,2336
4914,.466,2417,625,San Antonio Spurs*,7958,963,1641,1546,329,.761,1620,1249,1736,08/09,.386,3042,728,6534,82,474,3366,.492,19905,2638
5767,.447,2671,328,Oklahoma City Thunder,7952,1330,2069,1655,371,.786,949,1626,1663,08/09,.346,2999,999,6716,82,608,3496,.463,19805,2497
5457,.450,2599,395,Washington Wizards,7877,1146,1948,1679,365,.767,1198,1494,1641,08/09,.330,2994,956,6655,82,619,3286,.476,19705,2330
4840,.457,2355,556,New Orleans Hornets*,7857,1029,1833,1665,338,.807,1526,1479,1609,08/09,.364,2911,802,6366,82,593,3255,.487,19755,2453
5183,.441,2420,535,Los Angeles Clippers,7799,1221,1839,1650,482,.736,1513,1354,1723,08/09,.354,2955,890,6696,82,572,3267,.467,19880,2377
5480,.454,2604,377,Detroit Pistons*,7727,973,1849,1712,377,.751,1079,1388,1689,08/09,.349,2981,949,6559,82,493,3397,.475,19905,2448
5205,.454,2467,398,Memphis Grizzlies,7698,1252,2077,1777,385,.756,1106,1570,1423,08/09,.360,2865,847,6311,82,615,3184,.474,19805,2337
4960,.455,2376,490,Charlotte Bobcats,7677,1279,1965,1754,397,.740,1339,1455,1741,08/09,.366,2866,886,6299,82,580,3252,.479,19930,2366
5018,.492,2609,730,Phoenix Suns*,9039,1210,2117,1713,418,.770,1770,1631,1912,09/10,.412,3339,910,6788,82,479,3526,.520,19730,2616
5407,.469,2696,633,Golden State Warriors,8922,1204,2085,1886,340,.782,1687,1631,1839,09/10,.375,3329,753,7094,82,761,3150,.499,19730,2397
5161,.468,2580,544,Denver Nuggets*,8729,1136,2508,1844,417,.772,1517,1937,1719,09/10,.359,3124,889,6678,82,683,3394,.500,19780,2505
5368,.491,2788,439,Utah Jazz*,8547,1246,2233,1859,400,.741,1207,1654,2187,09/10,.364,3227,872,6575,82,675,3460,.519,19755,2588
5234,.482,2681,518,Toronto Raptors,8534,1100,2118,1819,384,.764,1397,1618,1804,09/10,.371,3199,806,6631,82,469,3313,.512,19780,2507
4153,.470,2164,841,Orlando Magic*,8426,1155,2176,1629,456,.724,2241,1575,1615,09/10,.375,3005,810,6394,82,512,3546,.521,19730,2736
5855,.469,2879,344,Memphis Grizzlies,8404,1248,2202,1655,399,.733,1020,1614,1543,09/10,.337,3223,1070,6875,82,645,3566,.492,19905,2496
5085,.447,2448,646,Houston Rockets,8395,1188,2022,1712,318,.772,1838,1561,1790,09/10,.351,3094,971,6923,82,583,3442,.481,19905,2471
4809,.485,2499,602,Cleveland Cavaliers*,8373,1137,2180,1591,425,.720,1582,1569,1835,09/10,.381,3101,791,6391,82,564,3483,.520,19780,2692
4731,.455,2384,743,New York Knicks,8373,1148,1759,1638,305,.782,2145,1376,1772,09/10,.346,3127,836,6876,82,586,3313,.504,19880,2477
5262,.464,2582,558,Dallas Mavericks*,8364,1059,1870,1563,449,.816,1498,1526,1917,09/10,.372,3140,834,6760,82,624,3420,.491,19880,2586
5313,.457,2612,532,Los Angeles Lakers*,8339,1096,1985,1592,400,.765,1562,1519,1730,09/10,.341,3144,973,6875,82,612,3635,.492,19830,2662
5346,.468,2657,524,Atlanta Hawks*,8338,980,1914,1632,413,.759,1455,1452,1789,09/10,.360,3181,969,6801,82,592,3420,.497,19855,2451
5400,.462,2645,418,Oklahoma City Thunder*,8322,1227,2210,1743,481,.805,1229,1778,1639,09/10,.340,3063,960,6629,82,654,3567,.490,19805,2607
5112,.473,2596,554,San Antonio Spurs*,8312,1116,1969,1669,381,.740,1547,1458,1829,09/10,.358,3150,887,6659,82,516,3508,.508,19780,2621
4927,.443,2361,659,Indiana Pacers,8263,1232,2019,1848,439,.775,1896,1564,1730,09/10,.348,3020,785,6823,82,585,3403,.479,19705,2618
5270,.464,2607,571,New Orleans Hornets,8220,1103,1661,1606,300,.778,1572,1293,1828,09/10,.363,3178,852,6842,82,625,3302,.495,19830,2450
5512,.456,2662,482,Sacramento Kings,8200,1226,1969,1827,366,.726,1383,1430,1679,09/10,.349,3144,977,6895,82,564,3495,.483,19880,2518
4861,.483,2540,499,Boston Celtics*,8136,1219,2090,1816,402,.746,1433,1559,1930,09/10,.348,3039,716,6294,82,701,3165,.523,19780,2449
5742,.449,2703,403,Minnesota Timberwolves,8051,1333,1926,1699,306,.746,1181,1436,1626,09/10,.341,3106,962,6923,82,597,3518,.471,19780,2556
5065,.461,2483,491,Portland Trail Blazers*,8045,1012,2033,1715,350,.790,1388,1606,1674,09/10,.354,2974,913,6453,82,523,3296,.490,19855,2383
5325,.460,2613,474,Philadelphia 76ers,8014,1192,1808,1677,439,.756,1381,1366,1723,09/10,.343,3087,941,6706,82,667,3362,.491,19805,2421
5185,.436,2405,645,Milwaukee Bucks*,8009,1085,1675,1823,385,.755,1813,1264,1740,09/10,.356,3050,965,6998,82,580,3525,.464,19980,2560
5759,.451,2729,352,Chicago Bulls*,7993,1175,1962,1648,478,.754,1066,1479,1704,09/10,.330,3081,937,6825,82,531,3652,.474,19905,2715
5092,.458,2490,494,Miami Heat*,7914,1079,1931,1710,457,.752,1426,1452,1548,09/10,.346,2984,875,6518,82,605,3428,.489,19880,2553
5475,.449,2576,432,Washington Wizards,7892,1219,1895,1752,421,.762,1225,1444,1557,09/10,.353,3008,966,6700,82,493,3424,.471,19830,2458
5144,.455,2519,483,Los Angeles Clippers,7849,1285,1867,1581,466,.730,1457,1362,1810,09/10,.332,3002,927,6601,82,532,3429,.490,19705,2502
4975,.453,2398,460,Charlotte Bobcats*,7813,1290,2180,1597,446,.751,1331,1637,1658,09/10,.346,2858,858,6306,82,632,3348,.482,19880,2490
5412,.445,2566,374,Detroit Pistons,7709,1100,1998,1822,313,.728,1190,1455,1591,09/10,.314,2940,1053,6602,82,596,3295,.474,19780,2242
5369,.429,2436,377,New Jersey Nets,7575,1182,2015,1643,393,.780,1185,1572,1540,09/10,.318,2813,897,6554,82,573,3255,.454,19780,2358
4909,.476,2483,662,Denver Nuggets*,8811,1157,2429,1719,352,.765,1704,1859,1813,10/11,.388,3145,791,6613,82,605,3443,.506,19705,2652
4786,.457,2375,765,New York Knicks*,8734,1123,2087,1743,475,.809,2081,1689,1757,10/11,.368,3140,847,6867,82,625,3317,.496,19780,2470
5132,.454,2493,677,Houston Rockets,8685,1110,2083,1641,371,.801,1843,1668,1955,10/11,.367,3170,962,6975,82,581,3511,.486,19880,2549
4987,.470,2518,701,Phoenix Suns,8611,1169,1939,1666,357,.759,1857,1472,1945,10/11,.377,3219,821,6844,82,545,3299,.505,20005,2478
5206,.464,2579,487,Oklahoma City Thunder*,8596,1156,2401,1836,487,.823,1403,1977,1672,10/11,.347,3066,903,6609,82,654,3507,.495,20005,2604
4901,.475,2463,685,San Antonio Spurs*,8502,1101,1984,1556,372,.767,1727,1521,1836,10/11,.397,3148,829,6628,82,602,3432,.503,19780,2603
5298,.461,2566,685,Golden State Warriors,8477,1198,1695,1806,406,.761,1749,1290,1847,10/11,.392,3251,955,7047,82,737,3325,.484,19830,2370
4822,.481,2484,547,Miami Heat*,8369,1142,2288,1674,430,.769,1479,1760,1639,10/11,.370,3031,790,6301,82,544,3456,.515,19780,2666
5270,.463,2604,524,Los Angeles Lakers*,8321,1073,1979,1555,422,.779,1487,1541,1801,10/11,.352,3128,989,6757,82,602,3605,.494,19830,2616
5449,.441,2501,589,Minnesota Timberwolves,8288,1398,1977,1825,422,.768,1565,1519,1650,10/11,.376,3090,1085,7014,82,592,3641,.459,19780,2556
4695,.475,2424,645,Dallas Mavericks*,8220,1145,1850,1575,352,.777,1768,1437,1954,10/11,.365,3069,780,6463,82,557,3398,.516,19705,2618
5875,.471,2891,309,Memphis Grizzlies*,8195,1145,1981,1705,441,.750,926,1486,1691,10/11,.334,3200,970,6801,82,771,3361,.492,19880,2391
5134,.442,2418,585,Indiana Pacers*,8183,1262,2035,1782,456,.782,1653,1592,1611,10/11,.354,3003,914,6787,82,584,3571,.471,19780,2657
5334,.465,2629,435,Utah Jazz,8153,1175,2061,1865,484,.771,1256,1590,1921,10/11,.346,3064,898,6590,82,629,3236,.493,19880,2338
5702,.449,2706,428,Sacramento Kings,8151,1324,1981,1805,391,.734,1277,1455,1675,10/11,.335,3134,1071,6979,82,608,3597,.475,19855,2526
4308,.461,2186,770,Orlando Magic*,8135,1224,2101,1640,384,.692,2103,1453,1636,10/11,.366,2956,864,6411,82,548,3543,.507,19830,2679
5664,.465,2799,345,Toronto Raptors,8124,1206,1976,1807,350,.755,1091,1491,1795,10/11,.316,3144,963,6755,82,581,3306,.494,19780,2343
5528,.461,2682,443,Philadelphia 76ers*,8119,1063,1851,1592,355,.770,1248,1426,1861,10/11,.355,3125,850,6776,82,621,3428,.485,19930,2578
5075,.457,2502,513,Los Angeles Clippers,8089,1343,2187,1733,402,.707,1519,1546,1813,10/11,.338,3015,955,6594,82,585,3456,.493,19855,2501
5172,.462,2531,511,Chicago Bulls*,8087,1161,2008,1639,468,.743,1415,1492,1827,10/11,.361,3042,967,6587,82,592,3621,.489,19830,2654
5706,.443,2656,392,Washington Wizards,7977,1258,1999,1850,502,.745,1182,1489,1592,10/11,.332,3048,1013,6888,82,665,3387,.465,19930,2374
5391,.460,2584,472,Detroit Pistons,7951,1067,1854,1629,328,.737,1256,1367,1730,10/11,.376,3056,931,6647,82,595,3167,.479,19880,2236
5100,.486,2615,408,Boston Celtics*,7913,1195,1895,1678,344,.770,1119,1459,1921,10/11,.365,3023,639,6219,82,676,3181,.513,19780,2542
5096,.447,2433,518,Portland Trail Blazers*,7896,1070,1835,1585,358,.804,1503,1476,1736,10/11,.345,2951,996,6599,82,660,3226,.477,19805,2230
5158,.434,2377,509,Cleveland Cavaliers,7827,1166,2075,1648,341,.745,1489,1546,1720,10/11,.342,2886,856,6647,82,544,3305,.461,19755,2449
5002,.462,2469,502,Atlanta Hawks*,7790,1118,1728,1554,341,.779,1427,1346,1802,10/11,.352,2971,762,6429,82,497,3222,.494,19730,2460
5184,.459,2500,444,New Orleans Hornets*,7784,1069,1897,1719,359,.765,1232,1452,1691,10/11,.360,2944,824,6416,82,624,3292,.482,19830,2468
5301,.440,2459,459,New Jersey Nets,7722,1152,1881,1807,384,.759,1337,1427,1723,10/11,.343,2918,909,6638,82,458,3349,.464,20005,2440
5162,.451,2480,393,Charlotte Bobcats,7650,1192,1999,1637,433,.756,1203,1511,1728,10/11,.327,2873,848,6365,82,524,3292,.480,19805,2444
5130,.430,2331,483,Milwaukee Bucks,7534,1103,1881,1682,399,.757,1414,1423,1545,10/11,.342,2814,862,6544,82,617,3342,.454,19830,2480
4093,.476,2137,435,Denver Nuggets*,6872,1015,1760,1297,330,.735,1311,1293,1581,11/12,.332,2572,738,5404,66,540,2843,.522,16040,2105
4058,.478,2059,552,San Antonio Spurs*,6841,895,1427,1143,293,.748,1405,1067,1528,11/12,.393,2611,683,5463,66,490,2836,.507,15940,2153
3912,.471,1990,472,Oklahoma City Thunder*,6802,1079,1744,1352,539,.806,1317,1406,1224,11/12,.358,2462,726,5229,66,498,2883,.509,15990,2157
4686,.456,2250,273,Utah Jazz*,6577,936,1668,1441,385,.754,845,1258,1439,11/12,.323,2523,861,5531,66,545,2916,.480,16165,2055
4387,.443,2066,436,Milwaukee Bucks,6535,929,1415,1273,335,.774,1265,1095,1550,11/12,.345,2502,820,5652,66,548,2803,.471,15865,1983
4411,.436,2079,411,Sacramento Kings,6518,952,1532,1287,323,.736,1301,1127,1271,11/12,.316,2490,882,5712,66,561,2829,.471,15915,1947
4182,.469,2076,370,Miami Heat*,6500,1002,1598,1282,355,.775,1030,1238,1317,11/12,.359,2446,686,5212,66,585,2746,.496,16040,2060
4150,.458,2051,444,Phoenix Suns,6492,928,1397,1233,366,.757,1295,1058,1486,11/12,.343,2495,717,5445,66,431,2752,.494,15840,2035
4213,.449,2011,478,Houston Rockets,6474,955,1301,1347,319,.782,1330,1018,1404,11/12,.359,2489,769,5543,66,496,2783,.477,16065,2014
4011,.433,1882,473,Minnesota Timberwolves,6464,1001,1662,1212,293,.771,1423,1281,1290,11/12,.332,2355,797,5434,66,436,2886,.469,15940,2089
3797,.443,1848,517,New York Knicks*,6458,1056,1634,1391,276,.741,1538,1211,1328,11/12,.336,2365,743,5335,66,622,2755,.487,15940,2012
4092,.457,1965,524,Golden State Warriors,6453,915,1235,1410,362,.770,1351,951,1470,11/12,.388,2489,640,5443,66,528,2587,.480,15915,1947
4311,.438,1962,392,Indiana Pacers*,6449,925,1724,1430,357,.782,1064,1349,1228,11/12,.368,2354,826,5375,66,523,2896,.455,15990,2070
3925,.455,1925,514,Los Angeles Clippers*,6438,879,1538,1399,315,.680,1441,1046,1385,11/12,.357,2439,800,5366,66,556,2743,.490,15965,1943
4207,.457,2067,362,Los Angeles Lakers*,6422,997,1589,1109,351,.756,1112,1202,1485,11/12,.326,2429,799,5319,66,390,3050,.491,16065,2251
4035,.443,1924,478,Portland Trail Blazers,6415,935,1423,1251,322,.796,1382,1133,1349,11/12,.346,2402,735,5417,66,528,2684,.477,15965,1949
4018,.454,1937,492,Atlanta Hawks*,6375,921,1385,1178,303,.740,1330,1025,1481,11/12,.370,2429,652,5348,66,536,2718,.482,16165,2066
4345,.452,2048,419,Chicago Bulls*,6359,923,1394,1139,388,.722,1117,1006,1527,11/12,.375,2467,915,5462,66,456,3080,.471,15940,2165
3948,.443,1901,497,Dallas Mavericks*,6322,926,1334,1226,337,.771,1464,1029,1380,11/12,.339,2398,665,5412,66,565,2822,.482,16065,2157
4573,.447,2148,277,Memphis Grizzlies*,6269,955,1504,1316,345,.759,849,1142,1290,11/12,.326,2425,831,5422,66,631,2775,.470,15940,1944
3377,.441,1605,670,Orlando Magic*,6215,984,1508,1168,275,.660,1785,995,1321,11/12,.375,2275,742,5162,66,451,2802,.475,15965,2060
4400,.441,2070,344,Washington Wizards,6180,1008,1386,1405,417,.727,1075,1008,1262,11/12,.320,2414,775,5475,66,527,2750,.470,15865,1975
4553,.448,2122,349,Philadelphia 76ers*,6180,738,1198,1157,340,.742,963,889,1453,11/12,.362,2471,704,5516,66,526,2848,.466,15915,2144
3839,.425,1755,507,New Jersey Nets,6144,995,1433,1268,260,.777,1481,1113,1311,11/12,.342,2262,783,5320,66,493,2662,.457,15890,1879
4087,.422,1821,440,Cleveland Cavaliers,6140,1017,1645,1317,262,.716,1273,1178,1308,11/12,.346,2261,841,5360,66,466,2790,.446,15965,1949
4098,.460,1978,363,Boston Celtics*,6062,979,1308,1315,362,.778,988,1017,1557,11/12,.367,2341,509,5086,66,498,2560,.483,15940,2051
4316,.438,1974,317,Detroit Pistons,5997,1033,1461,1293,278,.752,916,1098,1232,11/12,.346,2291,775,5232,66,460,2657,.457,15965,1882
4079,.440,1903,365,Toronto Raptors,5986,1001,1410,1532,321,.770,1075,1085,1382,11/12,.340,2268,697,5154,66,429,2771,.467,15965,2074
4326,.451,2041,259,New Orleans Hornets,5916,1024,1397,1324,316,.757,777,1057,1368,11/12,.333,2300,724,5103,66,488,2715,.472,15940,1991
4401,.414,1930,263,Charlotte Bobcats,5739,957,1462,1249,361,.746,892,1090,1326,11/12,.295,2193,677,5293,66,397,2571,.439,15890,1894
5465,.478,2818,521,Denver Nuggets*,8704,1253,2148,1682,533,.701,1518,1505,2002,12/13,.343,3339,1092,6983,82,762,3693,.516,19905,2601
4413,.461,2257,867,Houston Rockets*,8688,1348,2087,1662,359,.754,2369,1573,1902,12/13,.366,3124,909,6782,82,679,3561,.511,19780,2652
4916,.481,2528,598,Oklahoma City Thunder*,8669,1253,2196,1654,624,.828,1588,1819,1753,12/13,.377,3126,854,6504,82,679,3579,.514,19830,2725
4911,.481,2547,663,San Antonio Spurs*,8448,1206,1725,1427,446,.791,1764,1365,2058,12/13,.376,3210,666,6675,82,695,3387,.519,19880,2721
4539,.496,2431,717,Miami Heat*,8436,1143,1887,1533,441,.754,1809,1423,1890,12/13,.396,3148,676,6348,82,710,3166,.536,19880,2490
4625,.458,2326,715,Los Angeles Lakers*,8381,1232,2289,1467,429,.692,2015,1584,1818,12/13,.355,3041,942,6640,82,576,3674,.503,19755,2732
5208,.458,2472,658,Golden State Warriors*,8296,1236,1744,1753,346,.790,1632,1378,1845,12/13,.403,3130,885,6840,82,567,3686,.475,19805,2801
5264,.462,2576,606,Dallas Mavericks,8293,1144,1669,1698,454,.793,1628,1323,1906,12/13,.372,3182,767,6892,82,648,3437,.489,19980,2670
4856,.478,2533,627,Los Angeles Clippers*,8289,1197,1888,1716,461,.711,1752,1342,1958,12/13,.358,3160,938,6608,82,784,3413,.522,19730,2475
5223,.447,2476,610,Sacramento Kings,8219,1199,1869,1717,342,.769,1681,1437,1708,12/13,.363,3086,943,6904,82,671,3328,.474,19830,2385
4318,.448,2105,891,New York Knicks*,8196,988,1729,1650,294,.759,2371,1313,1579,12/13,.376,2996,890,6689,82,672,3326,.487,19730,2436
5527,.435,2527,601,Milwaukee Bucks*,8108,1156,1700,1554,550,.736,1670,1251,1876,12/13,.360,3128,1068,7197,82,685,3605,.457,19830,2537
5325,.454,2539,507,Utah Jazz,8038,1210,1883,1750,515,.764,1385,1439,1859,12/13,.366,3046,989,6710,82,690,3446,.477,19880,2457
4743,.464,2378,706,Atlanta Hawks*,8032,1219,1619,1473,369,.715,1901,1158,2007,12/13,.371,3084,758,6644,82,664,3351,.501,19855,2593
4811,.448,2336,673,Portland Trail Blazers,7995,1203,1680,1518,353,.776,1904,1304,1784,12/13,.353,3009,874,6715,82,538,3348,.486,19855,2474
5020,.446,2408,571,Toronto Raptors,7971,1124,1831,1836,392,.788,1665,1442,1765,12/13,.343,2979,871,6685,82,595,3297,.480,19980,2426
4784,.450,2314,628,Brooklyn Nets*,7944,1206,1958,1500,391,.731,1760,1432,1668,12/13,.357,2942,1047,6544,82,599,3507,.484,19855,2460
5320,.434,2446,547,Cleveland Cavaliers,7913,1149,1826,1737,334,.756,1581,1380,1694,12/13,.346,2993,1004,6901,82,647,3363,.460,19730,2359
5227,.439,2493,450,Minnesota Timberwolves,7851,1214,2042,1509,387,.742,1475,1515,1836,12/13,.305,2943,973,6702,82,700,3446,.477,19730,2473
5069,.465,2503,498,Boston Celtics*,7818,1181,1698,1717,365,.776,1390,1318,1843,12/13,.358,3001,654,6459,81,667,3187,.494,19840,2533
5462,.443,2581,480,Phoenix Suns,7805,1278,1618,1688,434,.744,1455,1203,1855,12/13,.330,3061,959,6917,82,659,3413,.473,19805,2454
5198,.449,2466,513,Detroit Pistons,7778,1241,1870,1623,400,.699,1440,1307,1742,12/13,.356,2979,991,6638,82,574,3454,.474,19805,2463
5367,.448,2587,506,Orlando Magic,7718,1191,1359,1591,358,.755,1537,1026,1871,12/13,.329,3093,890,6904,82,528,3502,.482,19780,2612
5115,.448,2420,535,New Orleans Hornets,7714,1193,1636,1673,440,.776,1474,1269,1721,12/13,.363,2955,988,6589,82,520,3414,.473,19780,2426
4926,.436,2290,555,Indiana Pacers*,7674,1227,1915,1623,513,.746,1599,1429,1645,12/13,.347,2845,1043,6525,81,580,3714,.465,19590,2671
5250,.425,2354,469,Charlotte Bobcats,7661,1153,2060,1561,479,.750,1399,1546,1587,12/13,.335,2823,917,6649,82,591,3306,.448,19805,2389
5572,.444,2582,382,Memphis Grizzlies*,7659,1144,1746,1660,436,.773,1107,1349,1715,12/13,.345,2964,1059,6679,82,703,3504,.463,19805,2445
5198,.435,2365,545,Washington Wizards,7644,1238,1746,1681,376,.733,1495,1279,1775,12/13,.365,2910,887,6693,82,598,3539,.455,19855,2652
5433,.437,2480,446,Chicago Bulls*,7641,1171,1738,1617,417,.773,1265,1343,1886,12/13,.353,2926,1026,6698,82,588,3540,.456,19830,2514
5457,.444,2541,518,Philadelphia 76ers,7640,1070,1377,1505,384,.729,1438,1004,1867,12/13,.360,3059,896,6895,82,609,3389,.466,19755,2493
4795,.474,2515,693,Los Angeles Clippers*,8850,1136,2384,1767,397,.730,1966,1741,2016,13/14,.352,3208,858,6761,82,703,3526,.525,19755,2668
4424,.472,2339,779,Houston Rockets*,8829,1323,2549,1676,461,.712,2179,1814,1755,13/14,.358,3118,920,6603,82,621,3717,.529,19830,2797
5418,.444,2589,600,Minnesota Timberwolves,8768,1142,2301,1504,297,.778,1757,1790,1963,13/14,.341,3189,1024,7175,82,718,3668,.478,19855,2644
5063,.450,2437,770,Portland Trail Blazers*,8753,1125,1926,1576,387,.815,2071,1569,1904,13/14,.372,3207,1022,7134,82,454,3808,.481,19855,2786
4943,.471,2530,664,Oklahoma City Thunder*,8705,1256,2052,1858,501,.806,1839,1653,1794,13/14,.361,3194,887,6782,82,678,3668,.512,19805,2781
5087,.486,2628,698,San Antonio Spurs*,8639,1180,1642,1495,420,.785,1757,1289,2064,13/14,.397,3326,762,6844,82,604,3548,.517,19755,2786
4790,.463,2407,765,Phoenix Suns,8629,1258,2004,1798,374,.758,2055,1520,1563,13/14,.372,3172,928,6845,82,688,3529,.503,19755,2601
4981,.474,2528,721,Dallas Mavericks*,8597,1110,1733,1636,356,.795,1877,1378,1935,13/14,.384,3249,840,6858,82,704,3354,.508,19830,2514
5083,.447,2445,702,Denver Nuggets,8559,1305,2154,1890,459,.726,1959,1563,1838,13/14,.358,3147,1009,7042,82,615,3726,.481,19755,2717
4968,.462,2462,774,Golden State Warriors*,8549,1247,1731,1784,407,.753,2037,1303,1912,13/14,.380,3236,896,7005,82,642,3715,.496,19830,2819
4948,.450,2365,774,Los Angeles Lakers,8442,1239,1835,1627,446,.757,2032,1390,2006,13/14,.381,3139,745,6980,82,611,3365,.478,19705,2620
4443,.501,2477,665,Miami Heat*,8380,1212,1884,1596,367,.760,1829,1431,1847,13/14,.364,3142,627,6272,82,732,3024,.558,19880,2397
4801,.445,2279,713,Toronto Raptors*,8305,1159,2055,1882,343,.782,1917,1608,1737,13/14,.372,2992,935,6718,82,577,3487,.475,19955,2552
5544,.447,2675,507,Detroit Pistons,8286,1193,2111,1666,395,.670,1580,1415,1714,13/14,.321,3182,1196,7124,82,687,3721,.483,19780,2525
4572,.458,2293,768,Atlanta Hawks*,8282,1251,1782,1577,326,.781,2116,1392,2041,13/14,.363,3061,713,6688,82,680,3278,.502,19830,2565
5216,.459,2530,647,Washington Wizards*,8254,1204,1715,1675,377,.731,1704,1253,1909,13/14,.380,3177,886,6920,82,668,3459,.485,20055,2573
5291,.447,2535,491,Sacramento Kings,8241,1249,2237,1849,318,.759,1475,1698,1547,13/14,.333,3026,990,6766,82,587,3646,.479,19830,2656
5458,.459,2615,486,New Orleans Pelicans,8177,1129,1936,1857,523,.769,1303,1489,1745,13/14,.373,3101,933,6761,82,647,3419,.479,19855,2486
5303,.435,2531,577,Philadelphia 76ers,8155,1384,1918,1844,330,.710,1847,1362,1791,13/14,.312,3108,949,7150,82,765,3505,.477,19855,2556
4701,.449,2268,759,New York Knicks,8084,1063,1670,1815,367,.761,2038,1271,1641,13/14,.372,3027,870,6739,82,631,3307,.482,19855,2437
4469,.459,2222,709,Brooklyn Nets*,8079,1191,2002,1777,311,.753,1922,1508,1714,13/14,.369,2931,721,6391,82,705,3128,.497,19880,2407
5315,.437,2452,584,Cleveland Cavaliers,8054,1163,1861,1640,304,.751,1640,1398,1738,13/14,.356,3036,989,6955,82,579,3618,.461,19930,2629
5259,.442,2460,516,Charlotte Bobcats*,7942,1010,2000,1493,421,.737,1471,1474,1778,13/14,.351,2976,776,6730,82,499,3500,.468,19905,2724
5031,.449,2399,550,Indiana Pacers*,7933,1237,1907,1675,446,.779,1542,1485,1651,13/14,.357,2949,834,6573,82,550,3665,.477,19780,2831
5188,.445,2459,563,Orlando Magic,7914,1222,1714,1678,350,.763,1596,1307,1726,13/14,.353,3022,794,6784,82,630,3448,.474,19955,2654
5154,.435,2421,575,Boston Celtics,7892,1261,1706,1743,343,.777,1729,1325,1726,13/14,.333,2996,980,6883,82,584,3485,.470,19730,2505
5576,.464,2717,405,Memphis Grizzlies*,7884,1124,1666,1568,375,.741,1147,1235,1792,13/14,.353,3122,950,6723,82,631,3476,.487,19805,2526
5184,.438,2404,548,Milwaukee Bucks,7829,1238,1843,1713,403,.747,1553,1377,1760,13/14,.353,2952,971,6737,82,541,3370,.464,19880,2399
5075,.444,2408,543,Utah Jazz,7791,1200,1803,1699,366,.747,1577,1346,1664,13/14,.344,2951,904,6652,82,570,3381,.474,19780,2477
5118,.432,2335,508,Chicago Bulls*,7680,1223,1908,1565,424,.779,1459,1486,1860,13/14,.348,2843,937,6577,82,594,3620,.456,19930,2683
4920,.478,2527,883,Golden State Warriors*,9016,1185,1709,1628,496,.768,2217,1313,2248,14/15,.398,3410,853,7137,82,762,3667,.514,19730,2814
4628,.473,2401,827,Los Angeles Clippers*,8751,1012,2067,1749,409,.710,2202,1468,2031,14/15,.376,3228,784,6830,82,640,3495,.519,19730,2711
4954,.463,2523,732,Dallas Mavericks*,8628,1062,1843,1644,371,.752,2082,1386,1846,14/15,.352,3255,858,7036,82,663,3466,.509,19880,2608
4769,.455,2382,726,Toronto Raptors*,8527,1057,2014,1712,357,.787,2060,1585,1701,14/15,.352,3108,881,6829,82,615,3407,.499,19855,2526
5255,.447,2552,632,Oklahoma City Thunder,8524,1205,2020,1829,454,.754,1864,1524,1681,14/15,.339,3184,1052,7119,82,598,3896,.486,19830,2844
4152,.444,2099,933,Houston Rockets*,8522,1366,2133,1803,407,.715,2680,1525,1820,14/15,.348,3032,958,6832,82,777,3582,.506,19805,2624
5007,.468,2531,677,San Antonio Spurs*,8461,1146,1754,1564,444,.780,1847,1368,2000,14/15,.367,3208,806,6854,82,657,3578,.505,19955,2772
4486,.458,2263,826,Cleveland Cavaliers*,8457,1171,1934,1510,340,.751,2253,1453,1814,14/15,.367,3089,911,6739,82,603,3523,.504,19780,2612
4818,.450,2368,807,Portland Trail Blazers*,8429,1117,1589,1494,372,.801,2231,1272,1799,14/15,.362,3175,879,7049,82,525,3760,.491,19855,2881
4547,.466,2303,818,Atlanta Hawks*,8409,1167,1735,1457,380,.778,2152,1349,2111,14/15,.380,3121,715,6699,82,744,3326,.506,19730,2611
4990,.452,2480,698,Phoenix Suns,8397,1238,1767,1744,385,.760,2048,1343,1659,14/15,.341,3178,896,7038,82,700,3539,.497,19880,2643
5126,.433,2439,660,Denver Nuggets,8320,1166,1991,1882,367,.734,2032,1462,1788,14/15,.325,3099,1012,7158,82,641,3665,.476,19880,2653
5190,.443,2533,660,Boston Celtics*,8312,1133,1678,1738,294,.754,2021,1266,2009,14/15,.327,3193,910,7211,82,674,3595,.488,19880,2685
5267,.455,2549,461,Sacramento Kings,8310,1333,2400,1696,324,.762,1350,1829,1667,14/15,.341,3010,895,6617,82,550,3623,.484,19855,2728
4972,.442,2356,645,Chicago Bulls*,8265,1145,2067,1495,476,.783,1825,1618,1781,14/15,.353,3001,959,6797,82,514,3751,.474,19880,2792
5212,.457,2522,586,New Orleans Pelicans*,8147,1087,1790,1530,510,.751,1583,1345,1806,14/15,.370,3108,942,6795,82,553,3563,.484,19780,2621
5409,.462,2642,497,Washington Wizards*,8080,1233,1758,1707,378,.742,1381,1305,1969,14/15,.360,3139,862,6790,82,601,3663,.488,19955,2801
4995,.432,2338,703,Detroit Pistons,8077,1099,1838,1559,383,.703,2043,1292,1771,14/15,.344,3041,1051,7038,82,623,3681,.468,19830,2630
5474,.435,2522,532,Los Angeles Lakers,8073,1086,1935,1741,366,.741,1546,1433,1715,14/15,.344,3054,952,7020,82,578,3599,.461,19930,2647
5517,.458,2674,423,Memphis Grizzlies*,8062,1094,1869,1567,347,.773,1246,1445,1777,14/15,.339,3097,856,6763,82,700,3490,.485,19905,2634
5171,.451,2528,541,Brooklyn Nets*,8038,1133,1817,1579,340,.748,1633,1359,1716,14/15,.331,3069,846,6804,82,576,3473,.489,19930,2627
5222,.459,2538,545,Milwaukee Bucks*,8023,1373,1734,1814,403,.757,1500,1312,1932,14/15,.363,3083,876,6722,82,789,3450,.486,19930,2574
5597,.438,2580,406,Minnesota Timberwolves,8016,1231,2110,1571,327,.776,1223,1638,1771,14/15,.332,2986,949,6820,82,668,3355,.461,19805,2406
5084,.439,2386,612,Indiana Pacers,7981,1147,1817,1742,375,.756,1740,1373,1757,14/15,.352,2998,856,6824,82,505,3678,.469,19855,2822
5194,.453,2522,554,Orlando Magic,7847,1221,1565,1714,314,.729,1598,1141,1692,14/15,.347,3076,822,6792,82,647,3429,.486,19755,2607
4711,.447,2290,610,Utah Jazz,7801,1256,1929,1583,489,.721,1781,1391,1632,14/15,.343,2900,988,6492,82,623,3605,.486,19705,2617
4671,.456,2329,556,Miami Heat,7764,1214,1940,1636,372,.741,1659,1438,1626,14/15,.335,2885,747,6330,82,642,3208,.499,19730,2461
5366,.420,2415,498,Charlotte Hornets,7721,976,1867,1494,448,.748,1566,1397,1654,14/15,.318,2913,820,6932,82,499,3613,.450,19905,2793
4617,.408,2073,692,Philadelphia 76ers,7542,1453,1953,1778,487,.676,2160,1320,1683,14/15,.320,2765,978,6777,82,789,3514,.449,19805,2536
5112,.428,2322,560,New York Knicks,7535,1206,1575,1768,382,.769,1614,1211,1746,14/15,.347,2882,867,6726,82,575,3310,.454,19855,2443
